"DATE","DESCRIPTION","AMOUNT","CURRENT BALANCE"
"04/05/2022","ELECTRONIC WITHDRAWAL BILL PAY XXXXX","-$162.99","$2,977.80"
"04/04/2022","TRANSFER - XXXXXXX XXXXXX","-$250.00","$3,140.79"
"03/31/2022","ELECTRONIC WITHDRAWAL BILL PAY XXXXXX XXX ","-$543.21","$3,390.79"
"03/29/2022","ELECTRONIC DEPOSIT - XXXXXX XXXX XXX","$2,000.00","$3,934.00"
"03/22/2022","CHECK #1234: SH DRAFT SHARE CHECK","-$100.00","$1,934.00"
"03/11/2022","ELECTRONIC DEPOSIT - SSA  TREAS 310  XXXXXXXX","$800.00","$2,034.00"
"03/11/2022","CHECK #1233: SH DRAFT SHARE CHECK","-$25.00","$1,234.00"
